###########    
#   #  s  # 
#      c  #   
# c       #
#      #  #
#  #   s  #
###########