21 21
........#####........
........#...#........
........#.s.#........
........#...#........
........##.##........
.........#.#.........
......####.####......
......#.......#......
#####.#.#...#.#.#####
#...###.......###...c
c.s.......c.......s.#
#...###.......###...c
#####.#.#...#.#.#####
......#.......#......
......####.####......
.........#.#.........
........##.##........
........#...#........
........c.s.c........
........#...#........
........##c##........