#######
#  #  #
#     #
# # # #
#     #
#     #
#######