###########    
#   #     # 
#         #   
# c       #
#      #  #
#         #
###########