21 21
#*w*#w*w#www#w*w#*w*#
#...................#
*.........s.........*
*..#.............#..*
#...##.##...##.##...#
*...................*
*...#...........#...*
#...#.....c.....#...#
*.c##...........##c.*
c...###.......###...c
d.s.......c.......s.d
#...###.......###...c
#c.##.#.#...#.#.##.c#
h..h..#.......#..h..h
h..##bb###.###bb##..h
h........d.d........h
h..#c.s.*#.#*.s.c#..h
h..######...######..h
h.........s.........h
h.......c...c.......h
hhhhhhhhh#d#hhhhhhhhh